Date,Severity 1,Severity 2,Severity 3,Severity 4, Severity 5,Total
7/17/12,9,34,18,15,1,77
7/18/12,10,37,21,21,1,90
7/19/12,11,45,29,23,1,109
7/20/12,11,47,32,23,1,114
7/26/12,10,67,45,38,1,161
7/27/12,11,68,50,41,1,171
7/30/12,10,71,50,41,1,173
7/31/12,11,72,52,40,1,176
8/1/12,3,10,14,9,0,36
8/2/12,2,10,13,3,0,28